31
28
XXXXXXXXXXXXXXXXXXXXXXXXXXXX
XB           XX           BX
X XXXX XXXXX XX XXXXX XXXX X
X XXXX XXXXX XX XXXXX XXXX X
X XXXX XXXXX XX XXXXX XXXX X
X                          X
X XXXX XX XXXXXXXX XX XXXX X
X XXXX XX XXXXXXXX XX XXXX X
X      XX    XX    XX      X
XXXXXX XXXXX XX XXXXX XXXXXX
XXXXXX XXXXX XX XXXXX XXXXXX
XXXXXX XX          XX XXXXXX
XXXXXX XX XXX__XXX XX XXXXXX
XXXXXX XX X 1  4 X XX XXXXXX
T         X 2    X         T
XXXXXX XX X   3  X XX XXXXXX
XXXXXX XX XXXXXXXX XX XXXXXX
XXXXXX XX          XX XXXXXX
XXXXXX XX XXXXXXXX XX XXXXXX
XXXXXX XX XXXXXXXX XX XXXXXX
X            XX            X
X XXXX XXXXX XX XXXXX XXXX X
X XXXX XXXXX XX XXXXX XXXX X
X   XX        P       XX   X
XXX XX XX XXXXXXXX XX XX XXX
XXX XX XX XXXXXXXX XX XX XXX
X      XX    XX    XX      X
X XXXXXXXXXX XX XXXXXXXXXX X
X XXXXXXXXXX XX XXXXXXXXXX X
XB                        BX
XXXXXXXXXXXXXXXXXXXXXXXXXXXX
