31
28
XXXXXXXXXXXXXXXXXXXXXXXXXXXX
XB          TXXT          BX
X XXXX       XX       XXXX X
X XXXX XXXXX XX XXXXX XXXX X
X XXXX XXXXX XX XXXXX XXXX X
X                          X
X XXXX XX XXXXXXXX XX XXXX X
X XXXX XX XXXXXXXX XX XXXX X
X      XX    XX    XX     BX
XXXXXX XXXXX XX XXXXX XXXXXX
XXXXXX XXXXX XX XXXXX XXXXXX
XXXXXX XX          XX XXXXXX
XXXXXX XX XXX  XXX XX XXXXXX
XXXXXX XX X  1   X XX XXXXXX
T         X 4  3 X         T
XXXXXX XX X   2  X XX XXXXXX
XXXXXX XX XXXXXXXX XX XXXXXX
XXT    XX          XX    TXX
XXXXXX XX XXXXXXXX XX XXXXXX
XXXXXX XX XXXXXXXX XX XXXXXX
XB           XX            X
X XXXX XXXXX XX XXXXX XXXX X
X XXXX XXXXX XX XXXXX XXXX X
X   XX        P       XX   X
XXX XX XX XXXXXXXX XX XX XXX
XXX XX XX XXXXXXXX XX XX XXX
X      XX    XX    XX      X
X XXXXXXXXXX XX XXXXXXXXXX X
X XXXXXXXXXX XX XXXXXXXXXX X
XB                        BX
XXXXXXXXXXXXXXXXXXXXXXXXXXXX
