31
28
XXXXXXXXXXXXXXXXXXXXXXXXXXXX
XB     XXX   XX  XXX      BX
X XXXX       XX       XXXX X
X XXXX XXXXX XX XXXXX XXXX X
X  XXX XXXXX XX XXXXX XXX  X
XX                        XX
X  XXX XX XXXXXXXX XX XXX  X
X XXXX XX XXXXXXXX XX XXXX X
X      XX     B    XX      X
XXXXXX XXXXXXXXXXXXXX XXXXXX
XXXXXX XXXXXXXXXXXXXX XXXXXX
XXXXXX XX          XX XXXXXX
XXXXXX XX XXX__XXX XX     TX
XXXXXX XX X  1   X XX XXXXXX
XXXXXX    X 4  3 X    XXXXXX
XXXXXX XX X   2  X XX XXXXXX
XXXXXX XX XXXXXXXX XX XXXXXX
XXT    XX          XX     TX
XXXXXX XX XXXXXXXX XX XXXXXX
XXXXXX XX XXXXXXXX XX XXXXXX
X           TXXT           X
X XXXXXX XXXXXXXXXX XXXXXX X
X XXXXXX XXXXXXXXXX XXXXXX X
X   XX        P       XX   X
XXX XX XX XXXXXXXX XX XX XXX
XXX XX XX XXXXXXXX XX XX XXX
X      XX    XX    XX      X
X XXX XXXXXX XX XXXXXX XXX X
X XXX XXXXXX XX XXXXXX XXX X
XB                        BX
XXXXXXXXXXXXXXXXXXXXXXXXXXXX